kosa dori	katate-aya-mochi
ai hanmi katate dori	katate-aya-mochi
katate-aya-mochi / katate-aya-mochi	katate-aya-mochi
shiho nage	shiho-nage
shiho, nage	shiho-nage
\<omote\>	(1)
\<ura\>	(2)
irimi nage	irimi-nage
tanto dori	tanto-dori
shinken tanto	shinken-tanto
 dori	-mochi
ikkyo	ikkajo
nikyo	nikajo
sankyo	sankajo
yonkyo	yonkajo
gokyo	gokajo
suwari waza	suwari-waza
uk√©	uke
kote gaeshi	kote-gaeshi
kokyu nage	kokyu-nage
, (1)	 (1)
, (2)	 (2)
tenchi nage	tenchi-nage
kajo osae	kajo-osae
men uchi	men-uchi
ushiro 	ushiro-
kokyu ho	kokyu-ho
ude kime nage	hiji-ate-kokyu-nage
 mochi	-mochi
hanmi handachi	hanmi-handachi
kaiten nage	kaiten-nage
hiji nage	hiji-nage
koshi nage	koshi-nage
kajo nage	kajo-nage
hiji garami	hiji-garami
te katana	te-katana
gedan barai	gedan-barai
mae geri	mae-geri
uke nagashi	uke-nagashi
katate osa	katate-osa
juji garami	juji-nage
aiki nage	aiki-nage
irimi kubishime	irimi-kubishime
seio otoshi	seio-otoshi
jodan tsuki	jodan-tsuki
jiyu waza	jiyu-waza
shikko ho	shikko-ho
seiza ho	seiza-ho
rei ho	rei-ho
hanmi-handachi waza	hanmi-handachi
kotegaeshi	kote-gaeshi
aiki jo	aiki-jo
aiki ken	aiki-ken
aiki otoshi	aiki-otoshi
sumi otoshi	aiki-otoshi
nage otoshi	nage-otoshi
chudan tsuki	shomen-tsuki
hara tsuki	shomen-tsuki
hiji shime	hiji-shime
shihonage	shiho-nage
